G G G G G
T T T T T
M M M M M
S S S S S
G G G G G